23 14
7 11
7 7 7 7 7 1 1 1 1 1 1 1 1 1 1 1 1 1 1 7 7 7 7
7 7 7 7 7 1 2 2 2 2 2 2 2 2 2 2 2 2 1 7 7 7 7
7 7 7 7 7 1 2 2 2 2 2 2 2 2 2 2 2 2 1 7 7 7 7
7 7 7 7 7 1 2 2 2 2 2 2 2 2 2 2 2 2 1 7 7 7 7
7 7 7 7 7 1 2 2 2 1 2 6 6 2 1 2 2 2 1 7 7 7 7
7 7 7 7 7 1 2 2 2 2 2 2 2 2 2 2 2 2 1 7 7 7 7
7 7 7 7 7 1 2 2 2 2 2 2 2 2 2 2 2 2 1 7 7 7 7
7 7 7 7 7 1 2 2 2 2 2 2 2 2 2 2 2 2 1 7 7 7 7
7 7 7 7 7 1 2 2 2 2 2 2 2 2 2 2 2 2 1 7 7 7 7
7 7 7 7 7 1 2 2 2 1 2 2 2 2 1 2 2 2 1 7 7 7 7
7 7 7 7 7 1 2 2 2 2 2 2 2 2 2 2 2 2 1 7 7 7 7
7 7 7 7 7 1 2 2 2 2 2 2 2 2 2 2 2 2 1 7 7 7 7
7 7 7 7 7 1 2 2 2 2 2 2 2 2 2 2 2 2 1 7 7 7 7
7 7 7 7 7 1 1 1 1 1 1 1 1 1 1 1 1 1 1 7 7 7 7
